111111111111111
001000110000111
110001101110011
101100001111101
111011111111111
111011111111111
100111111111111
100111111111111
101111111111111
101111001111111
100110110111111
111000110110001
100111110001101
101001111101100
111111111111111